11111111111111111111111111111
10101010101010101010101010101
11110000011100000000000010011
10010000000000000000000010001
11110000011100000000000010011
10000000001100000111011110001
11110111111111011100000010011
10110111111111011101010010001
11000000110101011100000010011
10000000000000001100000010001
11000000000000001100010000011
10000000110101000000000000001
11110111110101000000000000011
10000000001100000100000010001
11000000000000000000N00001011
10000000001000010000000001001
11000000001101000000000000011
10101010101010101010101010101
11111111111111111111111111111