11111111111111111111111111111
10000000000000000000000000001
10110000011100000000000010001
10010000000000000000000010001
10110000011100000000000010001
10000000001100000111011110001
10110111111111011100000010001
10110111111111011101010010001
10000000110101011100000010001
10000000000000001100000010001
10000000000000001100010000001
10000000110101000000000000001
10110111110101000000000000001
10000000001100000100000010001
10000000000000000000N00001001
10000000001000010000000001001
10000000001101000000000000001
10000000000000000000000000001
11111111111111111111111111111