11111111111111111111111111111
10000000000000000000000000001
10000000000000000000000000001
10000000000000010000000000001
10000000011111111110000000001
10000000000000000010000000001
10000000000000001110000000001
10000000000000001110000000001
10000000000000000010000000001
10000000000000000010000000001
10000000011111111110000000001
10000000010000000000000000001
10000000011111100000000000001
10000000000000100000000000001
10000000000000000000000000001
10000000000000000000000000001
11111111111111111111111111111